EA ./path_to_the_south_texture

NO ./path_to_the_north_texture 


            1000000000110000000000111111
     1    1011000001110000000000001
           10010000000000000000111111
11111111111110000111000000000001
1000000000110000011101111111111101
11110111111111011100000010001
1111011111111101101010010001
11100000011010101110000001111
11000000000000001100000100001
10100000000000001101010110001
1100000111010101 111011110S01
11110111 1110101 101111010001