NO ./pfhfgfgdjdj
SO ./path_to_the_south_texture
WE ./path_to_the_west_texture
EA ./path_to_the_east_texture

F 220,100,0
C 225,30,0

    1111111111111111111111111111
      1000000000110000000000111111
    111011000001110000000000001
     10010000000000000000111111
       111100000000000000001111
11111111111110000111000000000001
100000000011000001110111111111111
11110111111111011100000010001
1111011111111101101010010001
11100000011010101110000000111
110000000000000011000E00100001
101000000000000011010101100011
 1100000111110101111011110001
 1111111111111111111111111111