NO ./path_to_the_north_texture
SO ./path_to_the_south_texture
WE ./path_to_the_west_texture
EA ./path_to_the_east_texture

F 220,100,0
C 225,30,0

           11111111111111111111111
    111     1000000000110000000000111111
    101   111011000001110000000000001
    111    10010000000000000000111111
           110000000000000000111
11111111111110000111000000000001
100000000011000001110111111111111
11110111111111011100000010001
1111011111111101101010010001
11100000011010101110000001111
110000000000000011000000100001
10100000000000001101010110001
1100000111010101 111011110N01
11110111 1110101 101111010001
11111111 1111111 11111111111