NO    images/north.xpm
SO    images/south.xpm
WE    images/west.xpm
EA    images/east.xpm

F 220,11,55
C 135,206,235


                          1


        1111111111111111111111111
   11    100000000011000010100001
        1011000001110000000000001
        10010000000000000000N0001
111111111011000000100000000000001
1000000000110000010101111111111111
11110111111111011110000010001
11110111111111011101010010001
11000000110101011100000010001  1
10000000000000001100000010001
10000000000000001101010000001
1100000111010101111101111000111
11110111 1110101 101111010001
11111111 1111111 111111111111