        1111111111111111111111111
   11    100000000011000000000001
        1011000001110000000000001
        10010000000000000000S0001
        1001000000000000000000001
111111111011000001110000000000001
10000000001100000111011D111D11111
11110111111111011100000010001
11110111111111011101010010001
11000000110101011100000010001  1
10000000000000001100000010001
10000000000000001101010000001
11000001110101011111011D1000111
11110111 1110101 101111010001
11111111 1111111 111111111111